{
    "map": [
        [
            "000000000000000000000000000000000000000000",
            "000000000000000000000000000000000000000000",
            "0000TS000S0000000000000000S000000000000000",
            "000TTTT0000000000S00S000000000S00000000000",
            "00TTSTTT0S000S0000S0000S000000000S00000000",
            "0TTTTSSSS000000000000000000S000000S0000000",
            "TTTTTTTTTT0000000000S0000000S0000000000000",
            "lPPPPPPPPl00000S00000000SSS0000000S0000000",
            "l00000000l000000000000000SS00000S000000000",
            "S0X0S0SS0S0SSSSSS00000000S00S0S000000S0000",
            "lS00000000000000S0000000000000000000000000",
            "SSSSSSSSSSSSSSSSSSXXXXXSXSSSSSSSSSSSSSSSSS",
            "lPPPPPPPPlGGGGGGGGGSSGGGGGGGGSSGGGSGXGSGGG",
            "ZDUDDDDDDDDDDDDDDDSDDDSDDDDDSDDDDSDDDDDSDD",
            "SSSSSSSSXSSSSSXSSSSSSSSSSSSSSSSSSSSSSSSSSS",
            "SSSSSSSSSSSSSSSSSSSSSSSSSSSSSSSSSSSSSSSSSS"
        ],
        [
            [
                "chain.png",
                1703.3333333333333,
                398.3333333333333,
                27.0,
                40.0
            ]
        ]
    ]
}