{
    "map": [
        [
            "000000000000000000000000000000000000000000",
            "000000000000000000000000000000000S00000000",
            "000XXS000SX000000000000000S0000X0S00000000",
            "000TTTT0000000000X00S000000000S0XS00000000",
            "00TTSTTT0S000S0000S0000S000000000S00000000",
            "0TTTTSSSS000000X0000000S000S0000S0X0000X00",
            "TTTTTTTTTT000000X00XS0000000S00S0000000000",
            "lPPPPPPPPl0SS00S00000000SSS0000X00S0000X00",
            "l000X00X0l000SS0000X0SX00SS00000S000000000",
            "S0X0S0SX0S0SSSSSS00X000X0SX0S0X00S000S0000",
            "lS00000XX00X00X0S0000XS0S0X00S0S0000SS0000",
            "SSSSSSSSSSSSSSSSSSXXXXXSXSSSXXXSXSXSSXSSSS",
            "lPPPPPSPPlSGGGGGSGGSSXGGGGGGGSXGGGSGXGSGGG",
            "ZDUDDDDXDDDDDDDDDDSDDDSDDDDDSDDDDSSSSSXSDD",
            "SSSSSSSSSSSSSSSSSSSSSSSSSSSSSSSSSSSSSSSSSS",
            "SSSSSSSSSSSSSSSSSSSSSSSSSSSSSSSSSSSSSSSSSS"
        ],
        [
            [
                "chain.png",
                317,
                406,
                20.0,
                33.0
            ],
            [
                "chain.png",
                221,
                403,
                27.0,
                40.0
            ]
        ]
    ]
}