{
    "map": [
        [
            "SSSSSSSSSSSSSSSSSSSSSSSSSSSSSSSSSSSSSSSSSS",
            "S000000X0X00000000000000000000000000000XXS",
            "S000XXXXXX0000000000000000X00000000000X00D",
            "S0XXXXXXXXXSSSSSXXSSXXSXSTSSSXSXSXXSXSSXSS",
            "SXXXXXSSXS000XX000XX000X000000000XX00X0X0S",
            "SSXXXXXXX0S0S0SS00000000000X000000XX00000S",
            "SSSXXXXXXX000000SS00XX00X0X0X00000X000000S",
            "SSSSXPPPXl0000XX0SSSX000XXX000000XXX00000S",
            "SSSSXXXX0l0000000000XSX00XXX0000X00000000S",
            "SSSXXXXXXXXXXXXXX0000X0SXXX0XXXX0XX00X000S",
            "SSSSXXXXXXXXXXXXXXXSXXXXXSXXXXXXXXXXXXX00S",
            "SSSXXXXXXXXXXXSXSSXXXXXXXXXSXXXXXXXXXXXXXS",
            "lPPPPPPPPlGGGSGGGGGXXGGXGGSXGXXGGGXXXXXGXS",
            "ZXUXXXXXXXXSXXXXXXXXXXXXXSXXXXXXXXXXXXXXSS",
            "SSSSSSSSSSSSXXXXXXXXXSSSXXXXXXXXXXXXXXXSSS",
            "SSSSSSSSSSSSTSXXXXXXXXXXXXXXXXXXXXXXXXXSSS"
        ],
        []
    ]
}