{
    "map": [
        [
            "SSSSSSSSSSSSSSSSSSSSSSSSSSSSSSSSSSSSSSSSSS",
            "S00000000000000000000000000000000000000XXS",
            "S000XS000S0000000000000000S00000000000X00D",
            "S0SSSSSSSSSSSSSSSSSSSSSSSSSSSSSSSSSSSSSSSS",
            "SXXXSXXX0S000XX000X0000X000000000XX00X0X0S",
            "SSXXXXXSS000000000000000000X000000XX00000S",
            "SSSXXXXXXX0000000000XX00X0X0X000000000000S",
            "SSSSSPPPPl00000X00S0X000XXX000000XXX00000S",
            "SSSSSSSS0l00000000000S000XXX0000X00000000S",
            "SSSSSSSSSSSSSSSSS000000S0XX0S0S00S000X000S",
            "SSSSSSSSSSSSSSSSSXXXXXXXXXXXXXXXXXXXS0X00S",
            "SSSSSSSSSSSSSSSSSXXXXXXXXXXXXXXXXXXXSSXXXS",
            "lPPPPPPPPlGGGGGGGGGXSGGSGGSGGXXGGGXXXXXGSS",
            "ZXUXXXXXXXXXXXXXXXXSSXXXXXXSXXXXXXXXXXXSSS",
            "SSSSSSSSSSSSSSSSSSSSSSSSSSSSSSSSSSSSSSSSSS",
            "SSSSSSSSSSSSSSSSSSSSSSSSSSSSSSSSSSSSSSSSSS"
        ],
        [
            [
                "chain.png",
                1981.6666666666667,
                446.6666666666667,
                27.0,
                40.0
            ]
        ]
    ]
}