{
    "map": [
        [
            "000000000000000000000000000000000000000000",
            "000000000000000000000000000000000000000000",
            "0000TS000S0000000000000000S000000000000000",
            "000TTTT0000000000S00S000000000S00000000000",
            "00TTSTTT0S000S0000S0000S000000000S00000000",
            "0TTTTSSSS000000000000000000S000000S0000000",
            "TTTTTTTTTT0000000000S0000000S0000000000000",
            "lPPPPPPPPl00000S00000000S000000000S0000000",
            "l00000000l0000000000000000S00000S000000000",
            "l00000000l00000000000000000000S000000S0000",
            "l00000000000000000000000000000000000000000",
            "SSSSSSSSSSSSSSSSSSXXXXXSXSSSS00000S000S000",
            "lPPPPPPPPlGGGGGGGGGGGGGGGGGGGSSGGGGGGGSGGG",
            "ZDUDDDDDDDDDDDDDDDDDDDSDDDDDSDDDDSDDDDDSDD",
            "SSSSSSSSSXSSSXSXSXXXXXXSSXXXXSXXXXSSXSSSSS",
            "SSSSSSSSSXSSSSSSXSSXSXSXXXXXXXXXXXXSXSXSXS"
        ]
    ]
}